20 20 20 20 20 20 20 20 20 20 20 20 20 20 20 20 20 20 20 20 20 20 20 20 20 20 20 20 20 20 20 20 20 20 20 20 20 20 20 20 20 20 20 20 20 20 20 20 20 20 
20 17 17 17 17 17 17 17 17 17 17 17 17 17 17 17 17 17 04 17 17 17 17 22 01 17 17 17 17 17 17 17 17 17 17 17 17 17 17 17 17 17 04 18 17 17 17 17 17 20
20 17 17 17 17 17 17 17 17 17 17 17 17 17 17 17 17 17 04 17 09 17 17 22 01 17 17 17 17 17 17 17 17 17 17 17 17 17 17 17 17 17 04 19 19 19 19 17 19 20
20 17 17 17 17 17 17 17 17 17 17 17 17 17 17 17 17 17 04 17 17 17 17 22 17 17 17 17 17 17 17 17 17 17 17 17 17 17 17 17 17 17 04 17 17 17 17 00 17 20
20 17 17 17 17 17 17 17 17 17 17 17 17 17 17 17 17 17 04 17 17 17 17 22 01 17 17 17 17 17 17 17 17 17 17 17 17 17 17 17 17 17 04 17 17 17 17 17 17 20
02 02 02 02 02 02 15 02 02 02 02 02 02 02 15 02 02 02 02 02 07 02 02 07 02 02 15 02 02 02 02 15 15 02 02 02 02 02 07 02 02 02 02 02 02 07 15 02 02 02
20 17 17 17 17 17 17 17 17 17 17 17 17 17 17 17 17 17 17 17 17 17 17 22 01 17 17 17 17 17 17 17 17 17 17 17 17 17 17 17 17 17 04 17 17 17 17 17 17 20
20 17 17 17 17 17 17 17 17 17 17 17 17 17 17 17 17 17 17 17 17 17 17 22 01 17 17 17 17 17 17 17 17 17 17 17 17 17 17 17 17 17 04 17 17 17 17 17 17 20
20 17 17 08 08 08 08 08 08 08 08 08 08 08 08 08 08 08 08 08 08 08 01 22 01 17 17 17 17 17 17 17 17 17 17 17 17 17 17 17 17 17 04 17 17 17 17 17 17 20
20 17 17 17 17 17 17 17 17 17 17 17 17 17 17 17 17 17 04 17 17 09 01 22 01 17 17 17 17 17 17 17 17 17 17 17 17 17 17 17 17 17 04 17 17 17 17 17 17 20
20 08 08 08 08 08 08 08 08 08 08 08 08 08 08 08 17 17 04 17 17 09 01 22 01 17 17 17 17 17 17 17 17 17 17 17 17 17 17 17 17 17 04 17 17 17 17 17 17 20
20 17 17 17 17 20 20 20 20 17 17 17 17 17 17 17 17 17 04 17 17 09 01 22 01 17 17 17 17 17 17 17 17 17 17 17 17 17 17 17 17 17 04 17 17 17 17 17 17 20
20 17 17 20 20 17 17 17 20 17 17 17 17 17 17 17 17 17 04 17 17 09 01 22 01 17 17 17 17 17 17 17 17 17 17 17 17 17 17 17 17 17 04 17 17 17 17 17 17 20
20 17 17 17 17 17 17 18 20 17 17 17 17 17 17 17 17 17 04 17 17 09 01 22 01 17 17 17 17 17 17 17 17 17 17 17 17 17 17 17 17 17 04 17 17 17 17 17 17 20
20 17 17 20 20 17 17 17 20 17 17 17 17 17 17 17 17 17 17 17 17 09 01 22 01 17 17 17 17 17 17 17 17 17 17 17 17 17 17 17 17 17 04 17 17 17 17 17 17 20
20 17 17 17 17 20 20 20 20 17 17 17 17 17 17 17 17 17 04 17 17 09 01 22 01 17 17 17 17 17 17 17 17 17 17 17 17 17 17 17 17 17 04 17 17 17 17 17 17 20
20 17 17 17 17 17 17 17 17 17 17 17 17 17 17 17 17 17 04 17 17 09 01 22 01 17 17 17 17 17 17 17 17 17 17 17 17 17 17 17 17 17 04 17 17 17 17 17 17 20
20 17 17 17 17 17 17 17 17 17 17 17 17 17 17 17 17 17 04 17 17 09 01 22 01 17 17 17 17 17 17 17 17 17 17 17 17 17 17 17 17 17 04 17 17 17 17 17 17 20
20 17 17 17 17 17 17 17 17 17 17 17 17 17 17 17 17 17 04 17 17 09 01 22 01 01 17 17 17 17 17 17 17 17 17 17 17 17 17 17 17 17 04 17 17 17 17 17 17 20
20 17 17 17 17 17 17 17 17 17 17 17 17 17 17 17 17 17 04 17 17 01 17 22 17 01 17 17 17 17 17 17 17 17 17 17 17 17 17 17 17 17 04 17 17 17 17 17 17 20
20 01 17 01 01 01 01 01 01 01 01 01 01 01 01 01 01 01 01 01 01 17 17 22 17 17 01 01 01 01 01 01 01 01 17 01 01 01 01 01 01 01 01 01 01 01 17 01 01 20
20 17 17 17 17 17 17 17 17 17 17 17 17 17 17 17 17 17 17 17 17 17 17 14 17 17 17 17 17 17 17 17 17 17 17 17 17 17 17 17 17 17 17 17 17 17 17 17 17 20
20 01 01 01 01 01 01 01 01 01 01 01 01 01 01 01 01 01 01 01 01 17 17 22 17 17 01 01 17 01 01 01 01 01 01 01 01 01 01 01 01 01 01 01 01 17 01 01 01 20
20 17 17 17 17 17 17 17 17 17 17 17 17 17 17 17 17 17 04 17 17 01 17 22 17 01 17 17 17 17 17 17 17 17 17 17 17 17 17 17 17 17 04 17 17 17 17 17 17 20
20 17 17 17 17 17 17 17 17 17 17 17 17 17 17 17 17 17 04 17 17 17 01 22 01 17 17 17 17 17 17 17 17 17 17 17 17 17 17 17 17 17 04 17 17 17 17 17 17 20
20 17 17 17 17 17 17 17 17 17 17 17 17 17 17 17 17 17 04 17 17 17 01 22 01 17 17 17 17 17 17 17 17 17 17 17 17 17 17 17 17 17 04 17 17 17 17 17 17 20
20 17 17 17 17 17 17 17 17 17 17 17 17 17 17 17 17 17 04 17 17 17 01 22 01 17 17 17 17 17 17 17 17 17 17 17 17 17 17 17 17 17 04 17 17 17 17 17 17 20
20 17 17 17 17 17 17 17 17 17 17 17 17 17 17 17 17 17 04 17 17 17 01 22 01 17 17 17 17 17 17 17 17 17 17 17 17 17 17 17 17 17 04 17 17 17 17 17 17 20
20 17 17 17 17 17 17 17 17 17 17 17 17 17 17 17 17 17 04 17 17 17 01 22 01 17 17 17 17 17 17 17 17 17 17 17 17 17 17 17 17 17 04 17 17 17 17 17 17 20
20 17 17 17 17 17 17 17 17 17 17 17 17 17 17 17 17 17 04 17 17 17 01 22 01 17 17 17 17 17 17 17 17 17 17 17 17 17 17 17 17 17 04 17 17 17 17 17 17 20
20 17 17 17 17 17 17 17 17 17 17 17 17 17 17 17 17 17 04 17 17 17 01 22 01 17 17 17 17 17 17 17 17 17 17 17 17 17 17 17 17 17 04 17 17 17 17 17 17 20
20 17 17 17 17 17 17 17 17 17 17 17 17 17 17 17 17 17 04 17 17 17 01 22 01 17 17 17 17 17 17 17 17 17 17 17 17 17 17 17 17 17 04 17 17 17 17 17 17 20
20 17 17 17 17 17 17 17 17 17 17 17 17 17 17 17 17 17 04 17 17 17 01 22 01 17 17 17 17 17 17 17 17 17 17 17 17 17 17 17 17 17 04 17 17 17 17 17 17 20
20 17 17 17 17 17 17 17 17 17 17 17 17 17 17 17 17 17 04 17 17 17 01 22 01 17 17 17 17 17 17 17 17 17 17 17 17 17 17 17 17 17 04 17 17 17 17 17 17 20
20 17 17 17 17 17 17 17 17 17 17 17 17 17 17 17 17 17 04 17 17 17 01 22 01 17 17 17 17 17 17 17 17 17 17 17 17 17 17 17 17 17 04 17 17 17 17 17 17 20
20 17 17 17 17 17 17 17 17 17 17 17 17 17 17 17 17 17 04 17 17 17 01 22 01 17 17 17 17 17 17 17 17 17 17 17 17 17 17 17 17 17 04 17 17 17 17 17 17 20
20 17 17 17 17 17 17 17 17 17 17 17 17 17 17 17 17 17 04 17 17 17 01 22 01 17 17 17 17 17 17 17 17 17 17 17 17 17 17 17 17 17 04 17 17 17 17 17 17 20
20 17 17 17 17 17 17 17 17 17 17 17 17 17 17 17 17 17 04 17 17 17 01 22 01 17 17 17 17 17 17 17 17 17 17 17 17 17 17 17 17 17 04 17 17 17 17 17 17 20
20 17 17 17 17 17 17 17 17 17 17 17 17 17 17 17 17 17 04 17 17 17 01 22 01 17 17 17 17 17 17 17 17 17 17 17 17 17 17 17 17 17 04 17 17 17 17 17 17 20
20 17 17 17 17 17 17 17 17 17 17 17 17 17 17 17 17 17 04 17 17 17 01 22 01 17 17 17 17 17 17 17 17 17 17 17 17 17 17 17 17 17 04 17 17 17 17 17 17 20
20 17 17 17 17 17 17 17 17 17 17 17 17 17 17 17 17 17 04 17 17 17 01 22 01 17 17 17 17 17 17 17 17 17 17 17 17 17 17 17 17 17 04 17 17 17 17 17 17 20
20 17 17 17 17 17 17 17 17 17 17 17 17 17 17 17 17 17 04 17 17 17 01 22 01 17 17 17 17 17 17 17 17 17 17 17 17 17 17 17 17 17 04 17 17 17 17 17 17 20
20 17 17 17 17 17 17 17 17 17 17 17 17 17 17 17 17 17 04 17 17 17 01 22 01 17 17 17 17 17 17 17 17 17 17 17 17 17 17 17 17 17 04 17 17 17 17 17 17 20
20 17 17 17 17 17 17 17 17 17 17 17 17 17 17 17 17 17 04 17 17 17 01 22 01 17 17 17 17 17 17 17 17 17 17 17 17 17 17 17 17 17 04 17 17 17 17 17 17 20
20 17 17 17 17 17 17 17 17 17 17 17 17 17 17 17 17 17 04 17 17 17 01 22 01 17 17 17 17 17 17 17 17 17 17 17 17 17 17 17 17 17 04 17 17 17 17 17 17 20
20 17 17 17 17 17 17 17 17 17 17 17 17 17 17 17 17 17 04 17 17 17 01 22 01 17 17 17 17 17 17 17 17 17 17 17 17 17 17 17 17 17 04 17 17 17 17 17 17 20
20 17 17 17 17 17 17 17 17 17 17 17 17 17 17 17 17 17 04 17 17 17 01 22 01 17 17 17 17 17 17 17 17 17 17 17 17 17 17 17 17 17 04 17 17 17 17 17 17 20
20 17 17 17 17 17 17 17 17 17 17 17 17 17 17 17 17 17 04 17 17 17 01 22 01 17 17 17 17 17 17 17 17 17 17 17 17 17 17 17 17 17 04 17 17 17 17 17 17 20
20 17 17 17 17 17 17 17 17 17 17 17 17 17 17 17 17 17 04 17 17 17 01 22 01 17 17 17 17 17 17 17 17 17 17 17 17 17 17 17 17 17 04 17 17 17 17 17 17 20
20 20 20 20 20 20 20 20 20 20 20 20 20 20 20 20 20 20 20 20 20 20 20 20 20 20 20 20 20 20 20 20 20 20 20 20 20 20 20 20 20 20 20 20 20 20 20 20 20 20 
