18 18 18 18 18 18 18 18 18 18 18 18 18 18 18 18 18 18 18 18 18 24 45 45 45 45 45 45 45 45 45 45 45 45 45 45 45 45 45 45 45 45 45 45 45 45 45 45 45 45 
18 18 18 18 18 18 18 18 18 18 18 18 18 18 18 18 18 18 18 18 18 24 08 03 07 01 01 01 02 01 01 32 40 40 40 40 40 40 40 40 40 40 40 40 40 40 40 40 40 45
18 18 18 18 18 18 18 18 18 18 18 18 18 18 18 18 18 18 18 18 18 24 08 03 07 02 01 01 01 01 01 32 42 42 42 42 42 42 42 42 42 42 42 42 42 42 42 42 42 45
18 18 18 18 18 18 18 18 18 18 18 18 18 18 18 18 18 18 18 18 18 24 08 03 07 38 01 41 02 38 01 32 42 42 42 42 42 18 18 42 42 42 18 18 42 42 42 42 42 45
18 18 18 18 18 18 18 18 18 18 18 18 18 18 18 18 18 18 18 18 18 24 08 03 07 01 02 01 01 01 01 32 42 42 42 42 18 18 18 18 42 18 18 18 18 42 42 42 42 45
18 18 18 18 18 18 18 18 18 18 18 18 18 18 18 18 18 18 18 18 18 24 08 03 09 10 10 10 10 10 10 32 42 42 42 18 18 18 18 44 18 18 18 18 18 18 42 42 42 45
18 18 18 18 18 18 18 18 18 18 18 18 18 18 18 18 18 18 18 18 18 24 08 03 03 03 03 03 03 03 03 03 42 42 42 42 18 18 18 19 18 18 44 18 18 42 42 42 42 45
18 18 18 18 18 18 18 18 18 18 18 18 18 18 18 18 18 18 18 18 18 24 08 03 04 05 05 05 05 05 05 32 42 42 42 42 42 18 18 18 19 18 18 18 42 42 42 42 42 45
18 18 18 18 18 18 18 18 18 18 18 18 18 18 18 18 18 18 18 18 18 24 08 03 07 01 01 01 01 01 01 32 42 42 42 42 42 42 42 18 18 19 42 42 42 42 42 42 42 45
18 18 18 18 18 18 18 18 18 18 18 18 18 18 18 18 18 18 18 18 18 24 08 03 07 01 01 01 01 01 01 32 42 42 42 42 42 42 42 42 18 42 42 42 42 42 42 42 42 45
18 18 18 18 18 18 18 18 18 18 18 18 18 18 18 18 18 18 18 18 18 24 08 03 07 01 01 01 01 01 01 32 42 42 42 42 42 42 42 42 42 42 42 42 42 42 42 42 42 45
18 18 18 18 18 18 18 18 18 18 18 18 18 18 18 18 18 18 18 18 18 24 08 03 07 01 01 01 01 01 01 32 32 32 32 32 32 42 32 32 32 32 32 32 32 32 42 32 32 45
18 18 18 18 18 18 18 18 18 18 18 18 18 18 18 18 18 18 18 18 18 24 08 03 07 01 01 01 01 01 01 01 40 42 42 32 42 42 42 32 42 42 42 42 42 32 42 32 42 45
18 18 18 18 18 18 18 18 18 18 18 18 18 18 18 18 18 18 18 18 18 24 08 03 07 01 01 01 01 01 01 01 40 42 42 32 42 42 42 32 42 42 42 42 42 32 42 32 42 45
18 18 18 18 18 18 18 18 18 18 18 18 18 18 18 18 18 18 18 18 18 24 08 03 07 01 01 01 01 01 01 01 40 42 42 32 42 42 42 32 42 32 32 42 42 32 42 32 42 45
18 18 18 18 18 18 18 18 18 18 18 18 18 18 18 18 18 18 18 18 18 24 08 03 07 01 01 01 01 01 01 01 40 42 42 32 42 42 42 32 42 42 32 42 42 32 42 32 42 45
18 18 18 18 18 18 18 18 18 18 18 18 18 18 18 18 18 18 18 18 18 24 08 03 07 01 01 01 01 01 01 01 40 42 42 32 42 42 42 32 42 42 32 42 42 32 42 32 42 45
18 18 18 18 18 18 18 18 18 18 18 18 18 18 18 18 18 18 18 18 18 24 08 03 07 01 01 01 01 01 01 01 40 42 42 32 42 42 42 32 42 42 32 32 32 32 42 32 42 45
18 18 18 18 18 18 18 18 18 18 18 18 18 18 18 18 18 18 18 18 18 24 08 03 07 01 01 01 01 01 01 01 40 42 42 32 42 42 42 32 42 42 38 38 38 32 42 32 42 45
26 26 26 26 26 26 26 26 26 26 26 26 26 26 26 26 26 26 26 26 26 27 08 03 07 01 01 01 01 01 01 01 40 42 42 32 32 32 32 32 42 42 42 42 42 32 42 32 42 45
45 10 10 10 10 10 10 10 10 10 10 10 10 10 10 10 10 10 10 10 10 10 11 03 09 10 10 10 10 10 10 10 10 10 10 10 10 10 10 10 10 10 10 10 10 10 10 10 10 45
45 03 03 03 03 03 03 03 03 03 03 03 03 03 03 03 03 03 03 03 03 03 03 03 03 03 03 03 03 03 03 03 03 03 03 03 03 03 03 03 03 03 03 03 03 03 03 03 03 45
45 05 05 05 05 05 05 05 05 05 05 05 05 05 05 05 05 05 05 05 05 05 06 03 04 05 05 05 05 05 05 05 05 05 05 05 05 05 05 05 05 05 05 05 05 05 05 05 05 45
45 16 43 43 16 43 16 01 01 01 01 01 01 01 01 01 01 01 01 01 01 01 08 03 07 01 01 01 01 01 01 01 01 01 01 01 01 01 01 01 01 01 01 01 01 01 01 01 01 45
45 43 43 16 43 16 01 01 01 01 01 01 01 01 01 01 01 01 01 01 01 01 08 03 07 01 01 01 01 01 01 01 01 01 01 01 01 01 01 01 01 01 01 01 01 01 01 01 01 45
45 01 43 43 16 43 16 38 38 16 01 01 01 01 01 01 01 01 01 01 01 01 08 03 07 01 01 01 38 40 41 16 16 43 40 38 40 41 16 16 43 38 40 41 16 16 43 40 01 45
45 01 01 43 43 16 43 16 01 01 01 01 01 01 01 01 01 01 01 01 01 01 08 03 07 01 01 01 43 38 40 41 16 16 43 40 43 38 40 41 16 16 43 40 01 01 43 40 01 45
45 32 46 46 46 32 16 16 16 16 01 01 01 01 01 01 01 01 01 01 01 01 08 03 07 01 01 01 38 40 41 16 16 43 40 38 40 41 16 16 43 38 40 41 16 16 43 40 01 45
45 01 01 01 01 32 40 43 16 16 01 01 01 01 01 01 01 01 01 01 01 01 08 03 07 01 01 01 38 43 38 40 41 16 16 43 40 01 01 16 43 38 40 41 16 16 43 40 01 45
45 01 01 41 01 32 16 16 16 16 01 01 01 01 01 01 01 01 01 01 01 01 08 03 07 01 01 01 38 40 43 38 40 41 16 16 43 40 01 16 43 38 40 41 16 16 43 40 01 45
45 01 01 01 01 01 01 02 16 16 02 02 02 02 02 02 02 02 02 02 02 02 08 03 07 01 01 01 38 40 41 16 16 43 40 38 40 43 38 40 41 16 16 43 40 01 01 40 01 45
45 32 46 46 46 32 01 01 16 38 01 01 01 01 01 01 01 01 01 01 01 01 08 03 07 01 01 01 43 38 40 41 16 16 43 40 43 38 16 16 43 38 40 41 16 16 43 40 01 45
45 01 01 01 01 01 01 01 16 43 01 01 01 01 01 01 01 01 01 01 01 01 08 03 07 01 01 01 38 40 41 16 16 43 40 38 40 41 16 16 43 38 40 41 16 16 43 41 01 45
45 01 01 01 01 01 01 01 43 40 01 01 01 01 01 01 01 01 01 01 01 01 08 03 07 01 01 01 38 40 41 16 16 43 40 38 40 43 38 40 41 16 16 43 40 01 01 40 01 45
45 01 01 01 01 01 01 01 16 16 01 01 01 01 01 01 01 01 01 01 01 01 08 03 07 01 01 01 01 01 01 01 01 01 01 01 01 01 01 01 01 01 01 01 01 01 01 01 01 45
45 01 01 01 01 01 01 01 16 43 01 01 01 01 01 01 01 01 01 01 01 01 08 03 07 01 01 01 01 01 01 01 01 01 01 01 01 01 01 01 01 01 01 01 01 01 01 01 01 45
45 01 01 01 01 01 01 01 43 01 01 01 01 01 01 01 01 01 01 01 01 01 08 03 07 01 01 01 01 01 01 01 01 01 01 01 01 01 01 01 01 01 01 01 01 01 01 01 01 45
45 38 16 01 16 38 43 38 16 01 16 38 43 38 16 01 16 38 43 38 16 01 08 03 07 38 16 01 40 16 38 40 43 01 40 38 16 01 40 16 38 40 43 01 40 38 16 01 40 45
21 21 22 34 20 21 21 21 21 21 21 21 21 21 21 21 21 21 21 21 21 21 22 34 20 21 21 21 21 21 21 21 21 21 21 21 21 21 21 21 21 21 21 21 21 21 21 21 21 21
18 18 19 34 18 19 19 18 44 18 19 19 18 44 18 18 18 18 19 19 18 18 18 34 19 18 18 18 19 18 18 19 19 18 44 18 19 19 18 44 18 18 18 18 19 19 18 18 18 18
26 26 27 34 25 26 26 26 26 26 26 26 26 26 26 26 26 26 26 26 26 26 27 34 25 26 26 26 26 26 26 26 26 26 26 26 26 26 26 26 26 26 26 26 26 26 26 29 18 19
45 01 08 03 07 01 01 01 01 01 01 01 01 01 01 01 01 01 01 01 01 01 08 03 07 01 01 01 01 01 01 01 01 01 01 01 01 01 01 01 01 01 01 01 01 01 01 23 18 18
45 01 08 03 07 01 01 01 01 01 01 01 01 01 01 01 01 01 01 01 01 01 08 03 07 01 01 01 02 01 01 01 01 01 42 01 01 01 01 01 01 01 01 01 01 01 01 23 18 19
45 01 08 03 09 10 10 10 10 10 10 10 10 10 10 10 10 10 10 10 10 10 11 03 07 01 01 01 01 01 01 01 01 01 01 01 01 02 01 01 01 02 01 01 01 42 01 23 44 18
45 01 08 03 03 03 03 03 03 03 03 03 03 03 03 03 03 03 03 03 03 03 03 03 07 01 01 01 42 01 01 01 01 01 01 01 01 01 01 01 01 01 01 01 02 01 01 23 19 18
45 01 14 05 05 05 05 05 05 05 05 05 05 05 05 05 05 05 05 05 05 05 06 03 07 01 01 01 01 01 01 01 01 01 01 01 01 01 42 01 01 01 01 01 01 01 01 23 18 18
45 01 01 01 01 01 01 01 01 01 01 01 01 01 01 01 01 01 01 01 01 01 08 03 07 01 01 01 02 01 01 01 02 01 01 01 01 02 01 01 01 01 01 01 01 42 01 23 44 18
45 01 01 01 01 01 01 01 01 01 01 01 01 01 01 01 01 01 01 01 01 01 08 03 07 20 21 21 21 21 21 21 21 21 21 21 21 21 21 21 21 21 21 21 21 21 21 31 18 18
45 01 01 01 01 01 01 01 01 01 01 01 01 01 01 01 01 01 01 01 01 01 08 03 07 23 18 19 19 44 18 18 18 18 18 44 19 18 18 18 18 44 18 19 18 18 18 19 18 18
45 45 45 45 45 45 45 45 45 45 45 45 45 45 45 45 45 45 45 45 45 45 45 45 45 45 45 45 45 45 45 45 45 45 45 45 45 45 45 45 45 45 45 45 45 45 45 45 45 45 
01 02 03 04 05 06 07 08 09 10 11 12 13 14 15 16 17 18 19 20 21 22 23 24 25 26 27 28 29 30 31 32 33 34 35 36 37 38 39 40 41 42 43 44 45 46 47 48 49 50