20 20 20 20 20 20 20 20 20 20 20 20 20 20 20 20 20 20 20 20 20 20 20 20 20 20 20 20 20 20 20 20 20 20 20 20 20 20 20 20 20 20 20 20 20 20 20 20 20 20 
20 17 17 17 17 17 17 17 17 17 17 17 17 17 17 17 17 17 17 17 17 17 17 22 00 00 00 00 00 00 00 00 00 00 00 00 00 00 00 00 00 00 00 00 00 00 00 00 00 20
20 17 17 17 17 17 17 17 17 17 17 17 17 17 17 17 17 17 04 17 17 17 17 22 00 00 00 00 00 00 00 00 00 00 00 00 00 17 17 17 17 17 17 17 00 00 17 17 00 20
20 17 17 17 17 17 17 17 17 17 17 17 17 17 17 17 17 17 17 17 17 17 17 22 00 00 00 00 00 00 00 00 00 00 00 00 00 00 00 00 00 00 00 00 00 00 17 17 00 20
20 17 17 17 17 17 17 17 17 17 17 17 17 17 17 17 17 17 17 17 17 17 17 22 00 00 00 00 19 19 19 19 00 00 00 00 00 00 00 00 00 00 00 00 00 00 17 17 00 20
20 17 17 17 17 17 17 17 17 17 17 17 17 17 17 17 17 17 04 17 17 17 17 22 00 00 00 00 00 00 00 19 00 00 00 00 00 00 00 19 19 19 19 00 00 00 17 17 00 20
20 17 17 17 17 17 17 17 02 02 17 02 02 17 17 17 17 17 17 17 17 17 17 22 00 00 00 00 00 00 00 19 00 00 00 00 00 00 00 01 00 00 01 00 00 00 17 17 00 20
20 17 17 17 17 17 17 02 02 02 02 02 02 02 17 17 17 17 17 17 17 17 17 22 00 00 00 00 00 09 00 19 00 00 00 00 00 00 00 01 00 00 01 00 00 00 17 17 00 20
20 17 17 17 17 17 17 02 15 02 02 02 02 02 17 17 17 17 04 17 17 17 17 22 00 00 00 00 00 09 00 19 00 00 00 00 00 00 00 01 00 00 01 00 00 00 17 17 00 20
20 17 17 17 17 17 17 02 02 02 02 15 02 02 17 17 17 17 17 17 17 17 17 22 00 00 00 00 00 09 00 19 00 00 00 00 00 00 00 00 00 00 00 00 00 00 00 00 00 20
20 17 17 17 17 17 17 17 02 02 15 02 02 17 17 17 17 17 17 17 17 17 17 22 00 00 00 00 00 00 00 19 00 00 00 00 00 00 00 00 00 00 00 00 00 00 00 00 00 20
20 17 17 17 17 17 17 17 17 02 02 02 17 17 17 17 17 17 04 17 17 17 17 22 00 00 00 00 19 19 19 19 00 00 00 00 00 00 00 00 00 22 00 00 00 00 00 00 00 20
20 17 17 17 17 17 17 17 17 17 02 17 17 17 17 17 17 17 17 17 17 17 17 22 00 00 00 00 00 00 00 00 00 00 00 00 00 00 00 00 00 22 00 04 00 00 00 00 00 20
20 17 17 17 17 17 17 17 17 17 17 17 17 17 17 17 17 17 17 17 17 17 17 22 00 00 00 00 00 00 00 00 00 00 00 00 00 00 00 00 00 22 00 00 00 00 00 00 00 20
20 17 17 17 17 17 17 17 17 17 17 17 17 17 17 17 17 17 17 17 17 17 17 22 00 00 00 00 00 00 00 00 00 00 00 00 00 00 00 00 00 22 00 08 00 00 00 00 00 20
20 17 17 17 17 17 17 17 17 17 17 17 17 17 17 17 17 17 04 17 17 17 17 14 21 21 21 21 21 21 21 21 21 21 21 21 21 21 21 21 21 10 00 00 00 00 00 00 00 20
20 17 17 17 17 17 17 17 17 17 17 17 17 17 17 17 17 17 17 17 17 17 17 22 00 00 00 00 00 00 00 00 00 00 00 00 00 00 00 00 00 00 00 04 00 00 00 00 00 20
20 17 17 17 17 17 17 17 17 17 17 17 17 17 17 17 17 17 17 17 17 17 17 22 00 00 06 06 06 06 06 06 06 06 06 06 06 06 06 06 06 06 06 06 06 06 06 06 06 20
20 17 17 17 17 17 17 17 17 17 17 17 17 17 17 17 17 17 17 17 17 17 17 22 00 00 06 06 06 06 06 06 06 06 06 06 06 06 06 06 06 06 06 06 06 06 06 06 06 20
20 17 17 17 17 17 17 17 17 17 17 17 17 17 17 17 17 17 17 17 17 17 17 22 00 00 06 06 06 06 06 06 06 06 06 06 06 06 06 06 06 06 06 06 06 06 06 06 06 20
20 17 17 17 17 17 17 17 17 17 17 17 17 17 17 17 17 17 17 17 17 17 17 22 00 00 06 06 06 06 06 06 06 06 06 06 06 06 06 06 06 06 06 06 06 06 06 06 06 20
20 08 08 08 08 08 08 08 08 08 08 08 08 08 08 08 08 08 08 08 08 08 08 22 00 00 06 06 06 06 06 06 06 06 06 06 06 06 06 06 06 06 06 06 06 06 06 06 06 20
20 21 21 21 21 21 21 21 21 21 21 21 21 21 21 21 21 21 21 21 21 21 21 14 21 21 21 21 21 21 21 21 21 21 21 21 21 21 21 21 21 21 21 21 21 21 21 21 21 20
20 00 00 00 00 00 00 00 00 00 00 00 00 00 00 00 00 00 00 00 00 00 01 22 01 00 00 00 00 00 00 00 00 00 00 00 00 00 00 00 00 01 00 01 00 00 00 00 00 20
20 00 00 00 00 00 00 00 00 00 00 00 00 00 00 00 00 00 00 00 00 00 01 22 01 00 00 00 00 00 00 00 00 00 00 00 00 00 00 00 00 01 00 01 00 00 00 00 00 20
20 00 00 00 00 00 00 00 00 00 00 00 00 00 00 00 00 00 00 00 00 00 01 22 01 00 00 00 00 00 00 00 00 00 00 00 00 00 00 00 00 01 00 01 00 00 00 00 00 20
20 00 00 00 00 00 00 00 00 00 00 00 00 00 00 00 00 00 00 00 00 00 01 22 01 00 00 00 00 00 00 00 00 00 00 00 00 00 00 00 00 01 00 01 00 00 00 00 00 20
20 00 00 00 00 00 00 00 00 00 00 00 00 00 00 00 00 00 00 00 00 00 01 22 01 00 00 00 00 00 00 00 00 00 00 00 00 00 00 00 00 01 00 01 00 00 00 00 00 20
20 00 00 00 00 00 00 00 00 00 00 00 00 00 00 00 00 00 00 00 00 00 01 22 01 00 00 00 00 00 00 00 00 00 00 00 00 00 00 00 00 01 00 01 00 00 00 00 00 20
20 00 00 00 00 00 05 00 00 00 00 00 00 00 00 00 00 00 00 00 00 00 01 22 01 00 00 00 00 00 00 00 00 00 00 00 00 00 00 00 00 01 00 01 00 00 00 00 00 20
20 00 00 00 00 05 05 05 00 00 00 00 00 00 00 00 00 00 00 00 00 00 01 22 01 01 01 01 01 01 01 01 01 01 01 01 01 01 01 01 01 01 00 01 00 00 00 00 00 20
20 00 00 00 05 05 05 05 05 00 00 00 00 00 00 00 00 00 00 00 00 00 01 22 01 00 00 00 00 00 00 00 00 00 00 00 00 00 00 00 00 00 00 01 00 00 00 00 00 20
20 00 00 00 00 00 00 00 00 00 00 00 00 00 00 00 00 00 00 00 00 00 01 22 01 00 00 00 00 00 00 00 00 00 00 00 00 00 00 00 00 00 00 01 00 00 00 00 00 20
20 00 00 00 00 00 00 00 00 00 00 00 00 00 00 00 00 00 00 00 00 00 01 22 01 06 06 06 06 06 06 06 06 06 06 06 06 00 06 06 06 06 06 01 00 00 00 00 00 20
20 02 02 02 02 02 07 02 02 02 02 02 02 02 02 02 02 02 02 02 02 02 02 07 02 02 02 02 02 02 02 02 02 02 02 02 02 07 02 02 02 02 02 02 02 02 02 02 02 20
20 00 00 00 00 00 00 00 00 00 00 00 00 00 00 00 00 00 00 00 00 00 01 22 01 00 00 00 00 00 00 00 00 00 00 00 06 00 06 00 00 00 00 00 00 00 00 00 00 20
20 00 00 00 00 00 00 00 00 00 00 00 00 00 00 00 00 00 00 00 00 00 01 22 01 00 00 00 00 00 00 00 00 00 00 00 06 00 06 00 00 00 00 00 00 00 00 00 00 20
20 00 00 00 00 00 00 00 00 00 00 00 00 00 00 00 00 00 00 00 00 00 01 22 01 00 00 00 00 00 00 00 00 00 00 00 06 00 06 00 00 00 00 00 00 00 00 00 00 20
20 00 00 00 00 00 00 00 00 00 00 00 00 00 00 00 00 00 00 00 00 00 01 22 01 00 00 00 00 00 00 00 00 00 00 00 06 00 06 00 00 00 00 00 00 00 00 00 00 20
20 00 00 00 00 00 00 00 00 00 00 00 00 00 00 00 00 00 00 00 00 00 01 22 01 00 00 00 00 00 00 00 00 00 00 00 06 00 06 00 00 00 00 00 00 00 00 00 00 20
20 00 00 00 00 00 00 00 00 00 00 00 00 00 00 00 00 00 00 00 00 00 01 22 01 00 00 00 00 00 00 00 00 00 00 00 06 00 06 00 00 00 18 00 00 00 00 00 00 20
20 00 00 00 00 00 00 00 00 00 00 00 00 00 00 00 00 00 00 00 00 00 01 22 01 00 00 00 00 00 00 00 00 00 00 00 06 00 06 00 00 00 22 00 00 00 00 00 00 20
20 00 00 00 00 00 00 00 00 00 00 00 00 00 00 00 00 00 00 00 00 00 01 22 01 01 01 01 01 01 01 01 01 01 01 00 06 00 06 00 00 00 22 00 00 00 00 00 00 20
20 00 00 00 00 00 00 00 00 00 00 00 00 00 00 00 00 00 00 00 00 00 01 11 21 21 21 21 21 21 21 21 21 21 21 21 21 21 21 21 21 21 10 00 00 00 00 00 00 20 
20 00 00 00 00 00 00 00 00 00 00 00 00 00 00 00 00 00 00 00 00 00 01 00 01 09 09 09 09 09 09 09 09 09 09 09 09 09 09 09 09 09 09 09 00 00 00 00 00 20
20 00 00 00 00 00 00 00 00 00 00 00 00 00 00 00 00 00 00 00 00 00 00 00 00 00 00 00 00 00 00 00 00 00 00 00 00 00 00 00 00 00 00 00 00 00 00 00 00 20
20 00 00 00 00 00 00 00 00 00 00 00 00 00 00 00 00 00 00 00 00 00 00 00 00 00 00 00 00 00 00 00 00 00 00 00 00 00 00 00 00 00 00 00 00 00 00 00 00 20
20 00 00 00 00 00 00 00 00 00 00 00 00 00 00 00 00 00 00 00 00 00 00 00 00 00 00 00 00 00 00 00 00 00 00 00 00 00 00 00 00 00 00 00 00 00 00 00 00 20
20 08 06 04 08 06 04 08 06 04 08 06 04 08 06 04 08 06 04 08 06 04 08 06 04 08 06 04 08 06 04 08 06 04 08 06 04 08 06 04 08 06 04 08 06 04 08 06 04 20
20 20 20 20 20 20 20 20 20 20 20 20 20 20 20 20 20 20 20 20 20 20 20 20 20 20 20 20 20 20 20 20 20 20 20 20 20 20 20 20 20 20 20 20 20 20 20 20 20 20 
